40
43
1,1,1,1,1,1,1,1,1,1,1,1,1,1,1,1,1,1,1,1,1,1,1,1,1,1,1,1,1,1,1,1,1,1,1,1,1,1,1,1,1,1,1
1,1,1,1,1,1,1,1,1,1,1,1,1,1,1,1,1,1,1,1,1,1,1,1,1,1,1,1,1,1,1,1,1,1,1,1,1,1,1,1,1,1,1
1,1,1,1,1,1,1,1,1,1,1,1,1,1,1,1,1,1,1,1,1,1,1,1,1,1,1,1,1,1,1,1,1,1,1,1,1,1,1,1,1,1,1
1,1,1,1,1,1,1,1,1,1,1,1,1,1,1,1,1,1,1,1,1,1,1,1,1,1,1,1,1,1,1,1,1,1,1,1,1,1,1,1,1,1,1
1,1,1,1,1,1,1,1,1,1,1,1,1,1,1,1,1,1,1,1,1,1,1,1,1,1,1,1,1,1,1,1,1,1,1,1,1,1,1,1,1,1,1
7,7,7,7,1,1,1,1,1,1,1,1,1,1,1,1,1,1,1,1,1,1,1,1,1,1,1,1,1,1,1,1,1,1,1,1,1,1,1,1,1,1,1
7,3,3,3,3,3,3,3,3,3,3,3,3,3,3,3,3,3,3,3,3,3,1,1,0,0,0,3,3,3,3,3,3,3,3,7,7,3,3,3,3,3,7
7,3,3,3,3,3,3,3,3,3,3,3,3,3,3,3,3,3,3,3,3,3,3,1,1,1,1,1,7,7,7,3,3,3,3,7,7,3,3,3,3,3,7
7,3,3,3,3,3,3,3,3,3,3,3,3,3,3,3,3,3,3,3,3,3,3,3,3,3,3,3,3,3,7,3,7,7,3,3,3,3,7,7,3,3,7
7,7,7,7,7,7,3,3,3,3,3,3,3,3,3,3,3,3,3,3,3,3,3,3,3,3,3,3,3,3,7,3,7,7,3,3,3,3,7,7,3,3,7
7,7,7,7,7,7,3,3,3,3,3,3,3,3,3,3,3,3,7,7,7,7,7,7,7,7,3,3,3,3,7,3,7,7,7,7,7,7,7,7,3,3,7
7,3,3,3,7,7,3,3,3,3,7,7,7,7,3,3,3,3,7,7,7,7,7,7,7,7,3,3,3,3,7,7,7,7,7,7,7,7,7,7,3,3,7
7,3,3,3,7,7,3,3,3,3,7,7,7,7,3,3,3,3,3,3,3,3,3,3,3,3,3,3,3,3,3,3,3,3,3,3,3,3,3,3,3,3,7
7,3,7,7,7,7,3,3,3,3,7,7,7,7,3,3,3,3,3,3,3,3,3,3,3,3,3,3,3,3,3,3,3,3,3,3,3,3,3,3,3,3,7
7,3,7,7,7,7,3,3,3,3,3,3,3,3,3,3,3,3,3,3,3,3,3,3,3,3,3,3,3,3,7,7,3,3,7,7,7,7,7,7,7,7,7
7,3,3,3,3,3,3,3,3,3,3,3,3,3,3,3,3,3,3,3,3,3,3,3,3,3,3,3,3,3,7,7,3,3,7,7,7,7,7,7,7,7,7
7,3,3,3,3,3,3,3,3,3,3,3,3,3,3,3,7,7,7,7,7,7,7,7,7,7,3,3,3,3,7,7,3,3,7,7,7,7,7,7,7,7,7
7,7,7,7,7,7,7,7,7,3,3,3,3,3,7,7,7,7,3,3,3,3,7,7,7,7,3,3,3,3,3,3,3,3,7,7,7,7,3,3,7,7,7
7,7,7,7,7,7,7,7,7,7,7,3,3,3,3,3,7,7,3,3,3,3,3,3,3,7,3,3,3,3,3,3,3,3,7,7,7,7,3,3,7,7,7
7,3,3,3,3,3,3,3,3,3,3,3,3,3,3,3,7,7,7,7,7,7,7,3,3,7,3,3,3,3,3,3,3,3,3,3,3,7,3,3,7,7,7
7,3,3,3,3,3,3,3,3,3,3,3,3,3,3,3,3,3,3,3,3,3,3,3,3,7,3,3,3,3,3,3,3,3,3,3,3,7,3,3,7,7,7
7,3,3,3,3,3,3,3,3,3,3,3,3,3,3,3,3,3,3,3,3,3,3,3,3,7,3,3,3,3,3,7,7,7,3,3,3,7,3,3,7,7,7
7,3,3,3,3,3,3,3,3,3,3,3,3,3,3,3,7,7,7,7,7,7,7,7,7,7,3,3,3,3,3,7,7,7,3,3,3,7,3,3,7,7,7
7,3,3,3,3,3,3,3,3,3,3,3,3,3,3,3,7,3,3,3,3,3,3,3,7,7,3,3,3,3,3,7,7,7,3,3,3,7,3,3,7,7,7
7,3,3,3,3,3,3,3,3,7,7,3,3,3,3,3,7,3,3,3,3,3,3,3,7,7,3,3,3,3,3,7,7,7,3,3,3,3,3,3,3,7,7
7,3,3,3,3,3,3,3,3,7,7,3,3,3,3,3,7,3,3,3,3,3,3,3,7,7,3,3,3,3,3,7,7,7,3,3,3,3,3,3,3,7,7
7,3,3,3,3,3,3,3,3,7,7,3,3,3,3,3,7,3,3,3,3,3,3,3,7,7,3,3,3,3,3,7,7,7,3,3,3,3,3,3,3,7,7
7,3,3,3,3,3,3,3,3,7,7,3,3,3,3,7,7,7,7,3,3,3,7,7,7,7,3,3,3,3,3,7,7,7,3,3,3,3,3,3,3,7,7
7,3,3,3,7,7,7,7,7,7,7,3,3,3,3,7,7,7,7,3,3,3,7,7,7,7,3,3,3,3,3,7,7,7,3,3,3,3,3,3,3,7,7
7,3,3,3,7,7,7,7,7,7,7,3,3,3,3,7,7,7,7,3,3,3,7,7,7,7,3,3,3,3,3,7,7,7,7,7,7,7,7,7,7,7,7
7,3,3,3,3,3,3,7,7,7,7,3,3,3,3,7,3,3,3,3,3,3,3,3,3,7,3,3,3,3,3,3,3,3,3,3,3,3,3,3,3,3,7
7,3,3,3,3,3,3,3,7,7,7,3,3,3,3,7,3,3,3,3,3,3,3,3,3,7,3,3,3,3,3,3,3,3,3,3,3,3,3,3,3,3,7
7,3,3,3,3,3,3,3,7,7,7,3,3,3,3,3,3,3,0,3,3,3,3,3,3,3,3,3,3,3,3,3,3,3,3,3,3,3,3,3,3,3,7
7,3,3,3,3,3,3,3,7,7,7,3,3,3,3,3,3,3,3,3,0,3,3,3,3,3,3,3,3,3,3,3,3,3,3,3,3,3,3,3,3,3,7
7,7,7,3,3,3,3,3,7,7,7,7,7,7,1,1,1,1,3,3,3,3,3,1,1,1,1,1,1,7,7,7,7,7,7,7,7,7,7,7,7,7,7
7,7,7,3,3,3,3,3,7,7,7,7,7,1,1,1,1,1,3,3,3,0,3,1,1,1,1,1,1,1,7,7,7,7,7,7,7,7,7,7,7,7,7
7,3,3,3,3,3,3,3,7,7,7,7,1,1,1,1,1,1,3,0,3,3,0,1,1,1,1,1,1,1,1,7,7,7,7,7,7,7,7,7,7,7,7
7,3,3,3,3,3,3,3,7,7,7,1,1,1,1,1,1,1,3,3,3,0,3,1,1,1,1,1,1,1,1,1,7,7,7,7,7,7,7,7,7,7,7
7,3,3,3,3,3,3,3,7,7,1,1,1,1,1,1,1,1,0,3,3,3,0,1,1,1,1,1,1,1,1,1,1,7,7,7,7,7,7,7,7,7,7
7,7,7,7,7,7,7,7,7,1,1,1,1,1,1,1,1,1,1,1,1,1,1,1,1,1,1,1,1,1,1,1,1,1,7,7,7,7,7,7,7,7,7
